牆牆牆牆牆牆牆牆牆牆牆牆牆牆牆牆牆牆牆牆
牆　　　　　　　　　　　　　　　　　　牆
牆　　　　　　　　　　　　　　　　　　牆
牆　　　　　　　　　　　　　　　　　　牆
牆　　　　　　　　　　　　　　　　　　牆
牆　　　　　　　　　　　　　　　　　　牆
牆　　　　　　　　　　　　　　　　　　牆
牆　　　　　　牆牆牆牆牆牆　　　　　　牆
牆　　　　　　牆　　　　牆　　　　　　封
牆　　　　　　　　　　家牆　　　　　　封
牆　　　　　　　　　　家牆　　　　　　封
牆　　　　　　牆　　　　牆　　　　　　封
牆　　　　　　牆牆牆牆牆牆　　　　　　牆
牆　　　　　　　　　　　　　　　　　　牆
牆　　　　　　　　　　　　　　　　　　牆
牆　　　　　　　　　　　　　　　　　　牆
牆　　　　　　　　　　　　　　牆　　　牆
牆　　　　　　　　　　　　　　牆　　　牆
牆　　　　　　　　　　　　　　牆　　　牆
牆牆牆牆牆牆牆牆牆牆牆牆牆牆牆牆牆牆牆牆