牆牆牆牆牆牆牆牆牆牆牆牆牆牆牆牆牆牆牆牆
牆　　　　　　　　　　　　　　　　　　牆
牆　　　　　　　　　　　　　　　　　　牆
牆　　　　　　　　　　　　　　　　　　牆
牆　　　　　　　　　　　　　　　　　　牆
牆　　　　牆　　　　牆牆牆牆牆牆牆牆牆牆
牆　　　　牆　　　　牆　　　牆　　　　牆
牆　　　　牆　　　　牆　洞　牆　　　　牆
　　　　　牆　　　　　　　　牆　　　　牆
　　　　　牆　　　　牆牆牆牆牆　　　　牆
　　　　　牆　　　　　　　　　　　　　牆
　　　　　牆　　　　　　　　　　　　　牆
牆　　　　牆　　　　　　　　　　　　　牆
牆　　　　牆　　　　　　　　　　　　　牆
牆　　　　牆牆牆牆牆牆牆牆牆牆　　　　牆
牆　　　　　　牆　　　　　　　　　　　牆
牆　　　　　　牆　　　　　　　　　　　牆
牆　　　　　　牆　　　　　　　　　　　牆
牆　　　　　　牆　　　　　　　　　　　牆
牆牆牆牆牆牆牆牆封封封封牆牆牆牆牆牆牆牆