牆牆牆牆牆牆牆牆牆牆牆牆牆牆牆牆牆牆牆牆
牆　　　　　　　　　　　　　　　　　　牆
牆　　　　　　　　　　　　　　　　　　牆
牆　　　　　　　　　　　　　　　　　　牆
牆　　　牆牆牆牆牆牆牆牆牆牆牆牆　　　牆
牆　　　牆　　　　　　　　　　　　　　牆
牆　　　牆　　　　　　　　　　　　　　牆
牆　　　牆　　牆牆牆牆牆牆牆牆牆牆牆牆牆
封　　　牆　　牆　　　　　　　　　　　　
封　　　牆　　牆　　　　　　　　　　　　
封　　　牆　　牆　　　　　　　　　　　　
封　　　牆　　牆　　　　　　　　　　　　
牆牆牆牆牆　　牆　　牆牆牆牆牆牆牆牆牆牆
牆　　　　　　牆　　　　　　　　　　　牆
牆　　　　　　牆　　　　　　　　　　　牆
牆　　　牆牆牆牆牆牆牆牆牆牆牆牆　　　牆
牆　　　　　　　　　　　　　　　　　　牆
牆　　　　　　　　　　　　　　　　　　牆
牆　　　　　　　　　　　　　　　　　　牆
牆牆牆牆牆牆牆牆牆牆牆牆牆牆牆牆牆牆牆牆