牆牆牆牆牆牆牆牆牆牆牆牆牆牆牆牆牆牆牆牆
牆　　　　　　　　　　　　　　　　　　牆
牆　　牆　　牆　　牆　　牆　牆牆　　　牆
牆　　牆　　牆　　牆　　牆　牆牆　　　牆
牆　　牆　　牆　　牆　　牆　　　　　牆牆
牆　　牆　　牆　　牆　　　　　　　　牆牆
牆　　牆　　牆　　牆　　　牆牆牆牆牆牆牆
牆　　牆　　牆　　牆　　　牆　　　　牆牆
　　　　　　　　　　　　　牆　　　　牆牆
　　　　　　　　　　　　　　　　　　牆牆
　　　　　　　　　　　　　　　　　　牆牆
　　　　　　　　　　　　　牆　　　　牆牆
牆　　牆　　牆　　牆　　　牆　　　　牆牆
牆　　牆　　牆　　牆　　　牆牆牆牆牆牆牆
牆　　牆　　牆　　牆　　　　　　　　牆牆
牆　　牆　　牆　　牆　　牆　　　　　牆牆
牆　　牆　　牆　　牆　　牆　牆牆　　　牆
牆　　牆　　牆　　牆　　牆　牆牆　　　牆
牆　　　　　　　　　　　　　　　　　　牆
牆牆牆牆牆牆牆牆牆牆牆牆牆牆牆牆牆牆牆牆